##########
#@    .  #
#  $  $  #
# ##  ## #
# #.  $  #
# ##  ## #
#  .  .  #
#   $    #
#        #
##########