####################
#                  #
#    #######       #
#    #     #       #
#  ### ### ####    #
#  #  $      .#    #
#  # .#####  $###  #
#     $   ###  #   #
#  ##$#   .    #   #
#   #   #####  #   #
#   #     @  $ #.  #
#   ## ##   ####   #
#       .#         #
#        #         #
#        ########  #
#                  #
#                  #
####################
