########
# @    #
# # #  #
# $ .  #
#  .#  #
# $    #
########
