########
#   #  #
# @ $  #
### $ ##
#  ..  #
#      #
########
