####################
#                  #
#     ######       #
#   $      #       #
#   # .    #       #
#   #   $  #       #
#   ###.####       #
#     $            #
#   ### ##         #
#   #   #          #
#   # @ .          #
#   #####          #
#                  #
#                  #
#                  #
#                  #
#                  #
#                  #
####################
