########
#   #  #
# @ $$ #
#  ..  #
#   #  #
########
