####################
#                  #
#  ########        #
#  #      ####     #
#  #  $     @#     #
#  # .###    #     #
#  ###   $   #     #
#    $  # #  #     #
#   ###  .#  ####  #
#   #  ###    #    #
#   #        .#    #
#   #######   #    #
#         #$ ##    #
#         #        #
#        .#        #
#         #######  #
#                  #
#                  #
####################
