####################
#                  #
#  #####  #####    #
#  #   ####   #    #
#  #   $  $   #    #
#  #  . #     ##   #
#  #     .    #    #
#  ##  #  ### #    #
#  #   $  $   #    #
#  # #### # # ##   #
#  #     @ .  .#   #
#  ####### #####   #
#        #         #
#       ###        #
#        #         #
#        ########  #
#                  #
####################
