####################
#                  #
#  #######   ####  #
#  #      ####  #  #
#  #  $     .   #  #
#  # $### ###.# #  #
#  #   #  $    ##  #
#  ### ##$###  .#  #
#    $ .   $   .#  #
#   ### ##@###  #  #
#      #     ####  #
#      #######     #
#                  #
#   .  ######      #
#   ##        #    #
#   ############   #
#                  #
####################
