##########
#        #
#  . . $ #
# # ##   #
# # @ #  #
#  $ $   #
#  . .   #
# #  # $ #
#        #
##########