########
#      #
# @ $$ #
#  ..  #
#      #
########
