##########
#        #
#   . .  #
#  ## # ##
#  # @ # #
#  ## # ##
#        #
# $  $   #
#        #
##########