##########
#        #
#    $   #
#  @ .   #
#        #
##########
