##########
#@       #
#  ###   #
# $#.    #
#  ###   #
#   $    #
#####  # #
#        #
#.       #
##########